/* ************************************** */
/* * TEXTURES							* */
/* ************************************** */

NO ./textures/excalibur/stonebrick1.xpm									// north wall texture
SO ./textures/excalibur/stonebrick2.xpm									// south wall texture
WE ./textures/excalibur/stonebrick3.xpm									// west wall texture
EA ./textures/excalibur/stonebrick4.xpm									// east wall texture

D ./textures/excalibur/cake_plate.xpm									// door texture

F 220,215,210															// white-yellowish
C 150,140,130															// night blue

FL ./textures/excalibur/quartz_bricks.xpm								// floor texture
CE ./textures/excalibur/cobble_wall_top.xpm								// ceiling texture

//WP 5 ./textures/weapons/shotgun/shotgun								// weapon texture
//WP 1 ./textures/weapons/ak47/AK										// weapon texture

//SP	AMMO	-1 textures/excalibur/items/popped_chorus_fruit.xpm		// ammo pack
//SP	HP		-1 textures/excalibur/items/heart.xpm					// health pack
//SP	ARM		-1 textures/excalibur/items/chainmail_chestplate.xpm	// armor pack
//SP	STA		-1 textures/excalibur/items/feather.xpm					// stamina pack

/* ************************************** */
/* * MAP								* */
/* ************************************** */

1111111111111111111111111111111111111111111111111111111111111
1S00001000000010001000001000100010000000001000100000000010101
1011101011101011101110111011101011101011101110101111101010101
1000101010101000101000000010001010101010000010000010001010001
1011111110111010101011111111111010111110111110101110111011101
1000100000101010000000101000000000001000000010100010100000001
101111101110111010111010101111101011111110111110101D111111101
1D10001000000010100010101010101010000000001000001010000000101
1010111011101111101110101110101011101110101011101111111111111
1000001000101010001000101000100000101010100010100000001000001
1011111011101010101111101110101111101011101110111011111111101
1000001000101000101000100000000010000010000000001010101000001
1110111111101011111011101011101011101111101011111010101111101
1010100000100010101000001010001010001000101010001000100010001
1010101110101010101111101011111011111110111010101111111010111
1000100010001000D000001010001010D000100010001010D000100000001
1011111111111110111111101011101011111110101111101010111110111
1000001000101010100010101010000000001010100000001010000000001
1111101010101010101010111111111111101010101110111110101011111
1000D00010100000101000000000100000101000001010100000101010101
1010111110101011101011111011111110111111111010101111101110101
1010101000001000101010100010001010001000001000100010101010101
1110101010111111111010111010111011101111101011101110111010101
1000101010D01000100000001000000000100000000010001010000000101
1110101111101110101010101111101111101D10101110101011111110101
1010000010001010001010100010000010001010101000100000101000001
1011111011101011101010111110111111111011111111101010101111101
1000000000100000001010001000101010000000001010001010100010101
1011101111101111111111111010101011111111101010111010101010101
1010001000001010001010001010001000000010001000100010001010001
10101D1111101011101010111110111110101011111011111110111111101
1010100000101000100010001010000000101000100010001010000010001
1011101111111110101110101011111010111110101110111011101111101
1000100000100000100010101000001010101000100010000000100010001
1111111111111111111111111111111111111111111111111111111111111
1000101010100000100000101000000010001010100010001010000000001
1011101010101010101111101111101111101111101010111110111010101
1000100010101010100000000010100000100000001010000000001010101
1111111011101111101111111010111110101111111010101110111111101
1010100000001000001010001000000000100010000010101000101000001
1010101111111111111011101011111011111110111111101110101110111
1000000000001010100000000010101010000000101000000010001000001
1110111111101010101111111010101011111110101011111111111110111
1010001010000000001000001000001010100000000010101010001000001
1011101011101111111011101111101010101110111110101011101110101
1010101000000000101000100000001010001000100000101000000010101
1010101011111011101110111011111011111011101111101110101011101
1000001010000010001010101010100000001000100000001000101010101
1010111011101110101011101110111011111011101011111111101110101
1010001010000000100000000010000000000000001000000000001000001
1111111111111111111111111111111111111111111111111111111111111
