/* ************************************** */
/* * TEXTURES							* */
/* ************************************** */

NO ./textures/sol/*test*/ong/00.xpm // north wall texture
SO ./textures/solong/10.xpm // south wall texture
WE ./textures/solong/20.xpm // west wall texture
EA ./textures/solong/30.xpm // east wall texture


F 200,100,0
C 225,30,0

FL ./textures/solong/00.xpm // floor texture
CE ./textures/solong/10.xpm // ceiling texture

/* ************************************** */
/* * MAP								* */
/* ************************************** */

           111111111111111111111111111111
           100000000000000000000000000001
           1000000000000000M0000000000001
           100000000000000000000000000001
           1000000000000M0000000000000001
           100000000000000000000000000001
           111000000000000000111111111111
111111111111010000000000000001
101100000100010000000000000001
100001110101110000111000000001
111100010000010000101000000001
100111110101010000111000000001
110000000100010000000000000001
100111011110110000000000000001111111
1111010000101000000000000M0000000001
   101011010100000000000000000000001
   100001010000000000000000000000001
   111111011100000000000000001111111
   100000011100000000000000001
   101011011100000000000000001
   1010010000000000000000000011111
   100000000000000000N000000010001
   1000001010000000000000000010001
1111101011010000000000000000011111
101000100001000000000000000001
100010111101000000000000000001
1111111  111111111111111111111
