NO ./textures/wolf/bluestone.xpm // north wall texture
SO ./textures/wolf/colorstone.xpm // south wall texture
WE ./textures/wolf/eagle.xpm // west wall texture
EA ./textures/wolf/mossy.xpm // east wall texture

D ./textures/wolf/door.xpm // door texture

F 226,113,162 // pink
C 87,226,212 // light blue

FL ./textures/wolf/greystone.xpm // floor texture
CE ./textures/wolf/purplestone.xpm // ceiling texture

111111111111111111111111111111111111111111111111111111111111111111111111111111111
100000000000000000000000000000000000000000000000000000000000000000000000000000001
101010100000000000000000000000000000000000000000000000000000000000000000001010101
1010101010101000000000010001000100000000S0000000010101010100000000001010101010101
101010100000000000000000010001000000000000000000000000000000000000000000001010101
101010101010100000000001000100010000000000000000001010101000000000001010101010101
101010100000000000000000010001000000000000000000000000000000000000000000001010101
101010101010100000000001000100010000000000000000010101010100000000001010101010101
101010100000000000000000010001000000000000000000000000000000000000000000001010101
101010101010100000000001000100010000000000000000001010101000000000001010101010101
101010100000000000000000010001000000000000000000000000000000000000000000001010101
101010101010100000000001000100010000000000000000010101010100000000001010101010101
101010100000000000000000010001000000000000000000000000000000000000000000001010101
101010101010100000000001000100010000000000000000001010101000000000001010101010101
101010100000000000000000010001000000000000000000000000000000000000000000001010101
101010101010100000000001000100010000000000000000010101010100000000001010101010101
101010100000000000000000010001000000000000000000000000000000000000000000001010101
101010101010100000000001000100010000000000000000001010101000000000001010101010101
101010100000000000000000010001000000000000000000000000000000000000000000001010101
101010101010100000000001000100010000000000000000010101010100000000001010101010101
101010100000000000000000010001000000000000000000000000000000000000000000001010101
101010101010100000000001000100010000000000000000001010101000000000001010101010101
101010100000000000000000010001000000000000000000000000000000000000000000001010101
101010101010100000000001000100010000000000000000010101010100000000001010101010101
101010100000000000000000010001000000000000000000000000000000000000000000001010101
101010101010100000000001000100010000000000000000001010101000000000001010101010101
101010100000000000000000010001000000000000000000000000000000000000000000001010101
101010101010100000000001000100010000000000000000010101010100000000001010101010101
101010100000000000000000010001000000000000000000000000000000000000000000001010101
101010101010100000000001000100010000000000000000001010101000000000001010101010101
101010100000000000000000010001000000000000000000000000000000000000000000001010101
101010101010100000000001000100010000000000000000010101010100000000001010101010101
101010100000000000000000010001000000000000000000000000000000000000000000001010101
101010101010100000000001000100010000000000000000001010101000000000001010101010101
101010100000000000000000010001000000000000000000000000000000000000000000001010101
101010101010100000000001000100010000000000000000010101010100000000001010101010101
101010100000000000000000010001000000000000000000000000000000000000000000001010101
101010101010100000000001000100010000000000000000001010101000000000001010101010101
101010100000000000000000010001000000000000000000000000000000000000000000001010101
101010101010100000000001000100010000000000000000010101010100000000001010101010101
101010100000000000000000010001000000000000000000000000000000000000000000001010101
101010101010100000000001000100010000000000000000001010101000000000001010101010101
101010100000000000000000010001000000000000000000000000000000000000000000001010101
101010101010100000000001000100010000000000000000010101010100000000001010101010101
101010100000000000000000000000000000000000000000000000000000000000000000001010101
100000000000000000000000000000000000000000000000000000000000000000000000000000001
111111111111111111111111111111111111111111111111111111111111111111111111111111111