/* ************************************** */
/* * TEXTURES							* */
/* * TEXTURES							* */
/* * TEXTURES							* */
/* * TEXTURES							* */
/* ************************************** */

/* ************************************** */
/* * TEXTURES							* */
/* ************************************** */

NO ./textures/sol/*test*/ong/00.xpm
SO ./textures/solong/10.xpm
WE ./textures/solong/20.xpm
EA ./textures/solong/30.xpm

F 200,100,0
C 225,30,0

/* ************************************** */
/* * MAP								* */
/* ************************************** */

           111111111111111111111111111111
           000000000000000000000000000001
           100000000000000000000000000001
           100000000000000000000000000001
           100000000000000000000000000001
           100000000000000000000000000001
           111000000000000000111111111111
111111111111010000000000000001
101100000100010000000000000001
100001110101110000111000000001
111100010000010000101000000001
100111110101010000111000000001
110000000100010000000000000001
100111011110110000000000000001111111
111101000010100000000000000000000001
   101011010100000000000000000000001
   100001010000000000000000000000001
   111111011100000000000000001111111
   100000011100000000000000001
   101011011100000000000000001
   101001000000000000000000001
   100000000000000000N00000001
   100000101000000000000000001
111110101101000000000000000001
101000100001000000000000000001
100010111101000000000000000001
1111111  111111111111111111111
