/* ************************************** */
/* * TEXTURES							* */
/* ************************************** */

NO ./textures/excalibur/chiseled_quartz_block.xpm					// north wall texture
SO ./textures/excalibur/chiseled_quartz_block.xpm					// south wall texture
WE ./textures/excalibur/chiseled_quartz_block.xpm					// west wall texture
EA ./textures/excalibur/chiseled_quartz_block.xpm					// east wall texture

D ./textures/excalibur/quartz_block_chiseled_alt.xpm				// door texture

F 50,50,50															// gray-blueish
C 220,215,210														// white-yellowish

FL ./textures/excalibur/basalt_top.xpm								// floor texture
CE ./textures/excalibur/quartz_pillar_top.xpm						// ceiling texture

WP			5 textures/weapons/shotgun/shotgun						// weapon texture
WP			1 textures/weapons/ak47/AK								// weapon texture
WP			1 textures/weapons/wand/wand							// weapon texture

SP	AMMO	-2 textures/excalibur/items/popped_chorus_fruit.xpm		// ammo pack
SP	AMMO	-2 textures/excalibur/items/prismarine_shard.xpm		// ammo pack
SP	HP		-1 textures/excalibur/items/heart.xpm					// health pack
SP	ARM		-4 textures/excalibur/items/chainmail_helmet.xpm		// armor pack
SP	ARM		-4 textures/excalibur/items/chainmail_chestplate.xpm	// armor pack
SP	ARM		-4 textures/excalibur/items/chainmail_leggings.xpm		// armor pack
SP	ARM		-4 textures/excalibur/items/chainmail_boots.xpm			// armor pack
SP	STA		-1 textures/excalibur/items/feather.xpm					// stamina pack

SP	MOB		8 textures/solong/slime									// mob texture prefix
SP	MOB		8 1 textures/solong/slime								// mob texture prefix

SP	OBJ		8 0 textures/solong/5									// obj texture prefix
SP	OBJ		8 1 textures/solong/5									// obj texture prefix

/* ************************************** */
/* * MAP								* */
/* ************************************** */

11111111111111111111111111111111111111111111
1000000000000000000000000000000000000000000D
11111111111111111110000001111111111111111111
10M10M10M10M10M10M10000001M01M01M01M01M01M01
10010010010010010010000001001001001001001001
10000000000000000000000000000000000000000001
11111111111111111110000001111111111111111111
10M10M10M10M10M10M10000001M01M01M01M01M01M01
10010010010010010010000001001001001001001001
10000000000000000000000000000000000000000001
11111111111111111110000001111111111111111111
10M10M10M10M10M10M10000001M01M01M01M01M01M01
10010010010010010010000001001001001001001001
10000000000000000000000000000000000000000001
11111111111111111110000001111111111111111111
10M10M10M10M10M10M10000001M01M01M01M01M01M01
10010010010010010010000001001001001001001001
10000000000000000000000000000000000000000001
11111111111111111110000001111111111111111111
10M10M10M10M10M10M10000001M01M01M01M01M01M01
10010010010010010010000001001001001001001001
10000000000000000000000000000000000000000001
11111111111111111110000001111111111111111111
10M10M10M10M10M10M10000001M01M01M01M01M01M01
10010010010010010010000001001001001001001001
10000000000000000000000000000000000000000001
11111111111111111110000001111111111111111111
10M10M10M10M10M10M10000001M01M01M01M01M01M01
10010010010010010010000001001001001001001001
10000000000000000000000000000000000000000001
11111111111111111110000001111111111111111111
10M10M10M10M10M10M10000001M01M01M01M01M01M01
10010010010010010010000001001001001001001001
10000000000000000000000000000000000000000001
11111111111111111110000001111111111111111111
10M10M10M10M10M10M10000001M01M01M01M01M01M01
10010010010010010010000001001001001001001001
10000000000000000000000000000000000000000001
11111111111111111110000001111111111111111111
10M10M10M10M10M10M10000001M01M01M01M01M01M01
10010010010010010010000001001001001001001001
10000000000000000000000000000000000000000001
1111111111111111111DDDDDD1111111111111111111
10000000000000000000000000000000000000000001
100000000000000000000S0000000000000000000001
10000000000000000000000000000000000000000001
10000000000000000000000000000000000000000001
10000000000000000000000000000000000000000001
10000000000000000000000000000000000000000001
10000000000000000000000000000000000000000001
10000000000000000000000000000000000000000001
10000000000000000000000000000000000000000001
10000000000000000000000000000000000000000001
10000000000000000000000000000000000000000001
10000000000000000000000000000000000000000001
10000000000000000000000000000000000000000001
10000000000000000000000000000000000000000001
10000000000000000000000000000000000000000001
10000000000000000000000000000000000000000001
10000000000000000000000000000000000000000001
10000000000000000000000000000000000000000001
10000000000000000000000000000000000000000001
10000000000000O0O0O0O0O0O0O0O0O0000000000001
10000000000000000000000000000000000000000001
10000000000000000000000000000000000000000001
100000000000000P0P0P0P0P0P0P0P00000000000001
10000000000000000000000000000000000000000001
11111111111111111111111111111111111111111111
